111111111111111111111111111
10X00000100C000000000000001
100000001000000000000X00001
1000000010011110000C0000001
1000C0011100000001000000001
100000001100000000110000001
10000P000000000000000000011
111111111000000000000000001
100000000000001100000000011
100X00000100000E10001000001
100000011000001110000100001
100000001000C000010000000X1
100000C00000000000100000001
100000000000010000000C00001
1000000000000000000X0000101
111111111111111111111111111