111111111111111111111111111
100000001000000000000000001
100000001000000000000000001
100000001001111000000000001
100000011100000001000000001
100000001100000000110000001
10000P000000000000000000011
111111111000000000000000001
100000000000001100000000011
10000000010000E010001000001
100000011000001110000100001
100000001000C000010000000X1
100000000000000000100000001
100000000000010000000000001
100000000000000000000000101
111111111111111111111111111