11111111111111
10000000000001
1P000000000001
10000011000001
11000011000001
10000000000001
100X000000X001
11111111111111