11111111111111
10000000000001
1P00000000X001
10000011000001
1100001100C001
10000000000001
10000X0000X001
11111111111111